Абрам - Абрамий, Авраам, Авраамий, Аврам, Аврамий
Августа - Густа,Ава, Густа, Устя, Гуся, Гутя, Ага
Августина - Августа,Августинка, Ава, Густа, Устя, Гутя, Гуся, Тина
Авдей - Авдий
Авраам - Абрам,Аврамка, Авраха, Авраша, Абрамка, Абраха, Абраша
Агафон - Агапон,Агафонка, Агафоня, Афоня, Фоня, Агафоша, Фоша, Аганя, Агаша, Гапоша, Гапа, Ганя
Агафья - Агафьюшка, Аганя, Ганя, Ганюся, Ганюша, Ага, Агаха, Агаша, Гаша, Гася, Гапа
Аглаида - Аглаюшка, Агланя, Аглаша, Глаша, Ага, Агаша, Агуля, Гуля
Агнесса - Агня, Агнюша, Ага, Аганя, Ганя, Агуся, Ася, Неся
Агния - Агнея,Агня, Агнюша, Ага, Агуся, Ася
Агриппина - Агрипинка, Грипа, Рипа, Грапа, Гапа, Ина, Аграфенка, Феня, Граня, Граша, Гаша, Груня, Гуня, Грунятка, Груняка, Груша
Ада - Адка, Даша
Адам - Адамушка, Ада, Адя, Адаша
Аделина - Аделя, Деля, Ада, Адуля, Адуся, Адуша, Адюня, Ида, Алина, Лина
Адриан - Адриян,Адрианка, Адриаша, Адриаха, Адря, Адя, Андря, Андрюша, Адриянка, Янка, Адрияха, Адрияша, Яша
Акакий - Акаха, Акаша
Аким - Иоаким, Еким, Яким, Акимка, Кима, Якимка
Алевтина - Алевтинка, Тина, Аля, Ала
Александр - Лександр,Александрушка, Алексаня, Саня, Санюра, Санюта, Санюха, Санюша, Алексаха, Алексаша, Саша, Сашуха, Сашуля, Сашуня, Сашута, Сашура, Шура, Шуруня, Алекса, Алексюха, Алексюша, Аля, Лекса, Лексаня, Лексаша
Александра - Лександра,Александрушка, Алексаня, Саня, Санюра, Санюша, Алексаша, Саша, Сашуля, Сашуня, Сашура, Шура, Шурёна, Алекся, Алексюха, Алексюша, Аля, Ася, Адя, Ара, Ксана
Алексей - Лексей,Алексейка, Алёха, Лёха, Алёша, Лёша, Алёня, Лёня, Алёка, Лёка, Лёля, Аля, Алюня, Лексейка, Лекса, Лёкса
Алиса - Алиска, Аля, Ала
Алла - Ала, Аля, Алуня, Алуся
Альберт - Аля, Бера
Альбина - Альбинка, Бина, Алина, Аля, Ляля
Альфред - Альфредка, Альфа, Аля, Фреда
Ананий - Ананья,Анан,Ананя, Анаха, Анаша, Наня, Нана
Анастасий - Анастас, Настасий,Анастасей,Анастасьюшка, Анастаска, Настася, Стася, Ася
Анастасия - Настасия и Настасья,Анастасея и Настасея,Анастасиюшка, Анастаска, Настася, Настя, Нася, Ната, Ная, Наюся, Нюся, Настёна, Тёна, Настёха, Настуся, Туся, Настюля, Настюня, Настюра, Стюра, Настюха, Настюша, Настяха, Стася, Тася, Тая, Ася, Асюша, Сюша, Асюта, Сюта, Настасьюшка
Анатолий - Натолий,Анатолька, Натоля, Толя, Толюня, Толюся, Толяна, Толяха, Толяша, Натоха, Натоша, Тоша, Тося, Тота, Туся
Ангелина - Ангелинка, Гелина, Лина, Ангеля, Геля, Гела, Ела, Гелюся
Андрей - Андрейка, Андря, Андрюха, Андрюша, Андрюня
Андроник - Андрон и Андроний,Андроня, Дроня, Андроша, Ника, Никаха, Никаша, Никуся, Никуша
Анисья - Аниса,Анисьюшка, Аниса, Анися, Аня, Оня
Анна - Анночка, Аннушка, Аннуша, Аннуся, Аннюня, Нюня, Аня, Анюра, Нюра, Нюрася, Нюраха, Нюраша, Нюша, Анюта, Нюта, Аннета, Нета, Ася
Антон - Антонка, Антоня, Тоня, Антоха, Антоша, Тоша, Антося, Тося, Антя
Антонина - Антонинка, Тоня, Тонюня, Тонюра, Тонюся, Нюся, Тонюха, Тонюша, Антося, Тося, Антоша, Тоша, Нина, Ина
Апполония - Полина,Полинария,Аполлинарка, Аполя, Поля, Полина, Полюня, Полюша, Поляна, Лина, Апа
Аполлинарий - Аполлонушка, Аполоша, Апола, Поля, Аля, Апа
Ариадна - Ариадночка, Ара, Ада, Рада, Рида
Аристарх - Аристаха, Аристаша, Ристаша, Аристя, Аря
Арнольд - Арнольдик, Арноша, Аря, Ноля, Нодя
Арсений - Арсен и Арсентий,Арсеньюшка, Арсеня, Сеня, Арся, Арсюта, Арсюша, Сюша, Ася
Артемий - Артём,Артемей,Артемьюшка, Артя, Артюня, Тюня, Артюха, Артюша, Тюша, Артёмка, Артёмчик, Тёма, Артёша
Артур - Артурка, Артя, Атя, Артюша, Тура
Архип - Архипка, Аря
Афанасий - Афанас,Апанас,Афанасьюшка, Афанася, Фаня, Нася, Афоня, Фоня, Арося, Фося, Фоша, Апанаска, Панаса
Белла - Белка, Беля, Бэла
Богдан - Богданка, Богдаша, Дана, Богда, Бога, Бодя
Борислав - Бориска, Боря, Борюля, Борюня, Болюся, Борюха, Борюша, Боряха, Боряша, Боба
Вадим - Вадимка, Дима, Вадя, Вадиша, Вадюша
Валентин - Валя, Валюня, Валюся, Валюха, Валюша, Валяха, Валяка, Вака
Валентина - Валентинка, Валя, Валена, Валюня, Валюся, Валюха, Валюша, Вака, Тина
Валериан - Валерьян и Валер,Валера, Лера, Леруня, Леруся, Леруха, Леруша, Валя, Валюня, Валюся, Валюха, Валюша, Вака, Валерьянка, Валерьяша
Валерий - Валер,Валера, Лера, Леруня, Леруся, Леруха, Леруша, Валя, Валеша, Валюня, Валюся, Валюха, Валюша, Вака
Ванда - Вандочка, Вана
Варвара - Варварка, Варя, Варюня, Варюся, Варюта, Варюша, Ара, Вава
Варлаам - Варлам и Варламий,Варлаамка, Варламка, Варлаха, Варлаша, Лама
Варфоломей - Фоломей,Вахрам и Вахрамей,Варфоломейка, Варфоломка, Вара, Вахруша
Василий - Василей,Васильюшка, Василька, Василёк, Василько, Вася, Васёна, Васюня, Васюра, Сюра, Васюта, Сюта, Васюха, Васюша, Васяй, Васяня, Васята, Васяха, Васяша
Василиса - Васёна,Василиска, Василька, Вася, Васёна, Васеня, Васюня, Сюня, Васюра, Васюта, Сюта, Васюха, Васюша, Васяня, Васята
Венедикт - Веденей, Венедей,Венедиктушка, Веня, Вена, Виня, Ведя, Веденя
Вениамин - Веньямин,Вениаминка, Веня, Вена, Венюля, Венюра, Венюся, Венюша, Виня, Мина
Вера - Верка, Вераня, Вераха, Вераша, Веруля, Веруня, Веруся, Руся, Веруха, Веруша
Вероника - Вероничка, Вера, Вероня, Роня, Ронюша, Веруня, Веруша, Вика, Ника, Никаша, Никуша
Викентий - Викентьюшка, Вика, Викеша, Кеша, Кеня
Виктор - Викторка, Тора, Викта, Виктуся, Витя, Витюля, Витюня, Витюся, Витюха, Витюша, Витяня, Витяся, Витяха, Витяша, Витёша, Виша, Вишута, Вика
Виктория - Викторка, Викта, Виктуся, Вика, Викуша, Вита, Витуля, Витуся, Витуша, Витяня, Вира, Тора, Тоша, Туся
Виолетта - Виола, Вела, Вета, Вита, Витуля, Витуся, Туся, Воля, Летта
Виссарион - Виссарионка, Виссара, Вися, Виса
Виталий - Виталя, Таля, Вита, Витя, Витася, Витаха, Виташа, Витуля, Витюня, Витюха, Витюша, Витяна
Витольд - Вита, Витя, Витюша, Толя
Владимир - Владя, Ладя, Вадя, Вава, Вавуля, Вавуся, Дима, Володя, Володюка, Володюня, Волдюха, Володюша, Володяка, Володяша, Вова, Вовуля, Вовуся, Вовуша, Воля
Владислав - Владиславка, Слава, Славуня, Славуся, Владя, Ладя, Вадя
Влас - Влася
Всеволод - Всеволодушка, Всева, Сева, Володя, Вова, Вава, Водя, Воля, Лодя
Вячеслав - Вячеславка, Слава, Славуня, Славуся, Славуха, Вяча, Вава
Гавриил - Гаврил и Гаврила,Гаврилка, Гавря, Гаврюня, Гаврюся, Гаврюха, Гаврюша, Ганя, Ганюся, Ганюха, Ганюша, Гаганя, Гавша, Гаша, Гаврик
Галактион - Лактион,Галактионка, Галаня, Галаха, Галаша, Гаша, Гала, Галуня, Галюха, Галюша, Лактя
Галина - Галинка, Галинуша, Галя, Гала, Галёк, Галика, Галиха, Галиша, Галюня, Галюся, Галюха, Галюша, Гана, Ганя, Гася, Гуля, Аля, Лина, Линуся, Линуша, Ина
Гарри - Гарик, Гаря, Гера
Геннадий - Геннаша, Генаша, Гена, Геня, Генуся, Генуля, Генуха, Генуша, Гея, Геша
Генриетта - Генриетка, Генра, Гена, Гера, Гета, Гетуня, Гетуся, Грета, Ета, Рита
Генрих - Гена, Геня, Гера, Гаря
Георгий - Егорий,Гора, Жора, Гера, Геша, Гоша, Гошуля, Гуля, Гошуня, Гога, Гаря, Егорка, Егоня, Егоша, Егуня, Гуня
Герасим - Гарасим,Герася, Рася, Гера, Гераня, Геша, Гарася
Герман - Герма, Гермуся, Муся, Гера, Геруня, Геруся, Геруха, Геруша, Геша, Гема, Гемуля
Гертруда - Герта,Герта, Гета, Гетуня, Гетуся, Гера, Грета
Глафира - Глафирка, Глафа, Глаша, Гланя, Граня, Гранюша, Граша, Графа, Фира
Глеб - Глебка, Глебушка
Гликерия - Гликера,Гликера, Кера, Глика, Лика, Ликаша, Глитя, Глиха, Глаша, Гланя, Глира, Глера, Лера, Лукерька, Луша, Лушаня, Луня
Гордей - Гордейка, Гордя, Гордюня, Гордюха, Гордюша
Григорий - Григорьюшка, Григоря, Гриха, Гриша, Гришко, Гришака, Гришук, Гришаня, Гришата, Гришоня, Гришуня, Гришута, Гришуха, Гриня, Гринюха, Гринюша, Грика, Гора
Давид - Давыд,Давидка, Давидок, Додя, Дава, Видя
Данил - Данил, Данила,Данилка, Даниша, Даня, Дануся, Дуся
Дарья - Дарьюшка, Даря, Дарюха, Дарюша, Дарёна, Дарина, Даруня, Дарёха, Дарёша, Даша, Дашуля, Дашуня, Дашура, Дашута, Дашуха, Даня
Дементий - Дементьюшка, Деменя, Дёма
Демид - Демидка, Дёма, Дима
Демьян - Демьянка, Демьяша, Дёма
Денис - Денисий,Дениска, Деня, Денуся, Дуся, Деша
Джульетта - Джуля, Жюля, Юля, Юла, Юлушка
Диана - Дианка, Дина, Дия, Ана, Аня
Дмитрий - Митрий,Митрей,Дима, Димаха, Димаша, Димуха, Димуша, Димуля, Димуся, Митя, Митяй, Митюля, Митюня, Митюха, Митюша, Митяха, Митяша, Митря, Митраша, Митрюха, Митрюша
Донат - Донатка, Дона, Доня, Доняша, Ната
Дорофея - Дорофейка, Дора, Фея
Евгений - Евген,Евдений и Веденей,Евгеньюшка, Евгеня, Геня, Гена, Женя, Женюра, Женюша, Жеха, Жека, Евгеха, Евгеша, Геша, Еня, Енюта, Енюха, Енюша, Еняха, Еняша
Евгения - Евдения,Евгеньюшка, Евгеня, Геня, Женя, Женюра, Женюша, Евгеша, Ева, Еня, Енюта, Енюха, Енюша, Еняха, Еняша
Евграф - Евграфий,Еграф,Евграфка, Графа, Графуня, Евграша, Граша, Граня
Евдоким - Авдоким,Евдокимка, Ким, Евдокуша, Евдя, Евдоха
Евдокия - Авдокея и Евдокея,Евдокиюшка, Евдя, Евдоня, Доня, Доняха, Доняша, Евдося, Дося, Евдоха, Евдоша, Доша, Дуня, Дуняра, Дунятка, Дуняха, Дуняша, Евдуша, Душа, Авдотьюшка, Авдуся, Дуся
Евсевий - Евсей,Авсей,Евсейка, Евся, Евсюта, Еся, Сева
Егор - Егорка, Гора, Жора, Егоня, Егоша, Гоша, Гошуня, Егуня, Гуня, Гога
Екатерина - Катерина,Екатеринка, Катя, Катюха, Катюша, Катюра, Катюся, Катюля, Катяха, Катяша, Катёна, Рина
Елена - Олёна,Еленка, Лена, Ленуша, Ленуся, Леся, Еленя, Ёля, Елюша, Елюся, Люся, Алёнка, Лёна, Лёся, Лёля
Елизавета - Лизавета,Елизаветка, Вета, Лиля, Лиза, Лизуня, Лизуха, Лизуша, Лизура, Лизута, Лизаветка
Елисей - Елис,Елисейка, Лисейка, Елеся, Леся, Еля
Емельян - Амельян,Емельянка, Емельяша, Емеля, Меля, Мелёха, Мелёша
Еремей - Еремия,Еремейка, Ерёма, Еря, Ема
Ермолай - Ермак, Ермол,Ермолайка, Ермола, Ерма, Ермоха, Ермоша
Ерофей - Ерофейка, Ероха, Ероша, Ероня, Ера
Ефим - Ефимий,Ефимка, Фима, Фимуля, Фиша
Ефим - Ефимий,Ефимка, Фима, Фимуля, Фиша
Ефрем - Ефремка, Рема
Ефросиния - Апросинья, Афросинья,Ефросиньюшка, Фрося, Фросюша
Жанна - Жанка, Жануся
Захар - Захарий,Захарка, Захарушка
Зинаида - Зинаидка, Зина, Зинаха, Зинаша, Зинуха, Зинуша, Зинуля, Зинуся, Зиня, Зиша, Ина, Ида
Зиновий - Зиновей,Зина, Зинаха, Зинаша, Зинуха, Зинуша, Зинуля, Зинуся, Зена, Зяма
Зоя - Зойка, Зоюня, Зоюха, Зоюша, Зоюшка, Зоха, Зоша, Зося, Зая
Иван - Иванка, Иваня, Иванюха, Иванюша, Ивася, Ивасик, Иваха, Иваша, Иша, Ишута, Ваня, Ванюха, Ванюша, Ванюра, Ванюся, Ванюта, Ванята, Ива
Игнатий - Игнат,Игнатка, Игнаха, Игнаша, Игоня, Игоша
Игорь - Игорька, Игорёк, Игоряша, Игорюха, Игорюша, Горя, Игоша, Гоша, Гога, Готя, Игуля, Гуля, Игуся, Гуся
Изабелла - Изабелка, Белла, Бела, Иза
Изольда - Зольда, Золя, Иза
Илларион - Ларивон,Илларионка, Ила, Ларионка, Лариоха, Лариоша, Ларя, Ларюха, Ларюша
Илья - Ильюха, Ильюша, Иля, Иляха, Илюха, Илюша, Илюся, Люся, Илюня, Люня, Люля
Инга - Ингуша, Ина, Инуся
Инна - Иннушка, Ина, Инуся, Инуля, Инюта, Инюша, Инеска, Инура
Иннокентий - Иннокентьюшка, Ина, Инюша, Кеня, Кеха, Кеша
Иона - Ионка, Ионя, Оня
Иосиф - Иосип,Ёсип,Иося, Осипка, Ося
Ипполит - Аполит,Ипполитка, Поля, Полюня, Полюся
Ириада - Ираидка, Раида, Ида, Ира, Ируня, Ируся, Рая
Ираклий - Иракля, Ракля, Ира
Ирина - Орина,Иринка, Рина, Ириша, Ира, Ируня, Ируся, Ируша, Ирена, Рена, Ина, Инуля, Аринка, Ариша, Арюха, Арюша
Исаак - Сидор,Изя
Казимир - Казимирка, Казя, Мира
Камилл - Камилка, Мила, Миля, Кама, Каля
Капитолина - Капа, Капуля, Капуша, Кана, Толя, Тоня, Лина
Карл - Карлушка, Карлуша, Карлуня
Каролина - Каролинка, Кароля, Каля, Лина, Линуся
Карп - Карпушка, Карпуха, Карпуша, Карпуня
Кира - Кирка, Кируся, Кируша
Кирилл - Кирила, Кирилла,Кирилка, Киря, Кира, Кирюха, Кирюша, Кирюня, Кируся, Киряха, Киряша
Клавдий - Клавдей,Клавдиюшка, Клавдя, Клавдюха, Клавдюша, Клавдюня, Клава, Кланя, Клаха, Клаша, Клася, Ава
Клавдия - Клавдея,Клавдиюшка, Клавдя, Клавдюха, Клавдюша, Клавдюня, Кладя, Клава, Кланя, Клаха, Клаша, Клася, Ава
Клара - Кларка, Кларуха, Кларуша, Кларуся, Лара
милостевый; - Клим, Климентий,Климка, Климаша, Климуха, Климуша
Кондратий - Кондрат,Кондратьюшка, Кондратка, Кондраха, Кондраша, Коня
Константин - Константинка, Костя, Коста, Костюха, Костюша, Костюня, Костюра, Костяня, Костяха, Костяша, Кося, Котя, Коташа, Кока
Корнилий - Корней, Корнил, Корнила,Корнилка, Корнюха, Корнюша, Корнейка
Ксения - Ксенья,Ксеня, Ксенюша, Сеня, Сенюра, Ксеша, Ксюня, Сюня, Ксюра, Ксюта, Ксюша, Аксиньюшка, Акся, Аксюня, Аксюта, Аксюха, Аксюша, Ася
Кузьма - Козьма,Кузя, Кузюта, Кузяха, Кузяша, Кузёна
Лавр - Лавра,Лаврушка, Лавря, Лаврюня, Лаврюся, Лаврюша, Лара
Лаврентий - Лаврен,Лаврентьюшка, Лавреня, Лавря, Лаврюня, Лаврюся, Лаврюха, Лавроша
Лада - Ладонька, Ладуся, Ладушка
Лазарь - Лазарька, Лазуря, Зуря, Лазута, Заря
Лариса - Лариска, Лара, Ларуся, Ларуня, Ларуля, Лора
Лаура - Лаурка, Лара
Лев - Левушка, Левуня, Левуся, Лёва, Лёня, Лёся, Лёка
Леонард - Лёня, Лёра
Леонид - Леонидка, Леоня, Леня, Лёня, Ленюся, Леся, Лёся, Лёка, Лёха, Лёша, Ледя
Леонтий - Леон,Левонтий,Левонтьюшка, Леоня, Оня, Леня, Лёня, Лёва
Лидия - Лида, Лидоня, Лина, Лидуля, Лиля, Лидуня, Лидуся, Лидуха, Лидуша, Лика
Лилия - Лилианка, Лиана, Лина, Линуся, Линуха, Линуша, Лиля, Ляна, Яна, Аня, Лилюня, Лилюся, Лилюха, Лилюша, Лия
Лия - Лийка, Лиля
Луиза - Луизка, Лиза
Лука - Луканя, Луконя, Луня, Лукаря, Лукася, Лукаха, Лукаша
Лукьян - Лукан,Лукьянка, Луканя, Луконя, Луканка, Лукаша, Лутоня, Лутоха, Лутоша
Любовь - Люба, Любава, Любаня, Любаха, Любаша, Любуся, Люся, Буся, Любуша
Людмила - Людмилка, Люда, Людуся, Люся, Люсиша, Людаха, Людаша, Людуха, Людуша, Люля, Мила, Милаша, Милуся, Милуша, Мика
Магдалина - Магда,Магдалинка, Магда, Мага, Лина
Майя - Мая, Маюня, Маюха
Макар - Макарка, Макарша, Макаша, Мака, Мара
Максим - Макс,Максимка, Макся, Максюта, Максюша, Мака, Сима
Максимилиан - Максимильян,Максимильянка, Максим, Макся, Сима, Лианка
Маргарита - Рита,Маргаритка, Рита, Ританя, Ритоха, Ритоша, Ритуля, Ритуня, Ритуся, Туся, Ритуша, Марга, Марго, Маргоша, Маргуша, Мара, Маруся, Мага, Мака
Мариан - Марьян,Марья, Мара
Марианна - Марьяна,Марианка, Маря, Мара, Марьянка, Яна, Марьяся, Марьяха, Марьяша
Марина - Маринка, Маринуша, Мариша, Маша, Марися, Мара, Маруся, Муся, Ина
Мариэтта - Мари, Мара, Маря, Мариня, Мариша, Марийка, Эта
Мария - Марья,Марея,Марийка, Мариша, Мара, Маруня, Маруля, Муля, Маруся, Муся, Мася, Масята, Марюта, Марюха, Марюша, Муша, Маня, Манюра, Манюся, Манюта, Манюха, Манюша, Манятка, Мака, Маняша, Маша, Машаня, Машутка, Машуня, Муня, Машура, Мура, Шура, Машара, Машута, Мута, Машуха, Марьюшка, Марьяша
Марк - Маркуха, Маркуша, Маркуся, Мася, Мартуся, Туся, Мара, Мака
Мартин - Мартын,Мартиня, Мартя, Мартиша, Мартюня, Мартюха, Мартюша, Маря, Мартынка
Марфа - Марфонька, Марфуня, Марфута, Марфуха, Марфуша, Марфеня, Мара, Маруша
Матвей - Матвейка, Матя, Матюха, Матюша, Матяха, Матяша, Мотя
Матильда - Матильдочка, Матя, Мотя
Матрона - Матронка, Матроша, Рона, Матрёха, Матрёша, Матря, Матрюха, Матрюша, Матряха, Матряша, Маря, Матя, Матюля, Матюся, Муся, Туся, Матюха, Матюша, Тюша, Матяша, Мотря, Мотя
Медея - Меда, Дея
Мелания - Меланья,Меланьюшка, Меланя, Ланя, Лана, Мелаша, Миля, Моля, Малаха, Малаша, Маля
Милон - Миланка, Мила, Милан
Милена - Миленка, Мила, Милуся, Милуша, Милица
Мирон - Миронка, Мироха, Мироша, Моша, Моня, Роня
Мирослав - Мира, Слава
Митрофан - Митрофаний,Митрофанка, Митрофаха, Митрофаша, Митроха, Митроша, Троша, Тоша, Митра, Митря
Михаил - Михайла,Михайлушка, Миха, Миша, Мишака, Мишаня, Мишара, Мишата, Мишука, Мишуля, Мишуня, Мишура, Мишута, Михаля, Миханя, Михася, Миня, Миняша, Минюша, Мика, Михай
Модест - Модестка, Модя
Моисей - Мосей,Моисейка, Мося, Мосейка, Мосяка, Моня, Монюка, Муля, Муня, Муся
Мстислав - Мстиша, Стива, Слава
Муза - Музка
Надежда - Надеждушка, Надя, Надея, Надёна, Надёха, Надюха, Надюша, Надюра, Надюся, Надина, Дина, Динуся, Надиша
Назар - Назарка, Зара, Зора, Зоря
Наталия - Наталья,Натальюшка, Наталя, Натаня, Натаха, Наташа, Таша, Ната, Натуля, Натуня, Натуся, Туся, Наля, Таля, Талюша, Тата, Татуся
Наум - Наумка, Нюма, Нёма
Нелли - Неля, Нэла
Нестор - Нестер,Несторка, Неся
Никандр - Никандра,Никандрушка, Никанка, Ника, Никаха, Никаша, Никуся, Никуша, Кана
Никанор - Никанорка, Никанка, Никаноха, Никаноша, Ника, Никаха, Никаша, Никуша, Кана, Канаша, Нора
Никита - Никитий,Микита,Никитка, Ника, Никиха, Никиша, Никуся, Никуша, Никеня, Кеня, Никеша, Кеша, Кита
Никодим - Никодимка, Ника, Никаха, Никаша, Никуся, Никуша, Дима, Димаха, Димаша, Димуся, Димуха, Димуша, Кодя, Кодяша
Николай - Миколай, Микола,Николайка, Николаха, Николаша, Николя, Коля, Колюня, Колюся, Колюха, Колюша, Коляня, Коляша, Кока, Ника, Никаха, Никаша, Никуся, Никуша, Николка, Никула, Никоша
Никифор - Микифор,Никифорка, Никиша, Ника, Никуша, Никуся
Нил - Нилка
Нина - Нинка, Нинака, Нинока, Нинаня, Ниноня, Ниноха, Ниноша, Нинуля, Нинуня, Нуня, Нинура, Нинуся, Нуся, Нинуха, Нинуша, Ника, Нита
Нонна - Ноннушка, Нона, Нонуся, Ноннета
Олег - Олегушка, Олежик, Олеся, Оля, Олюся, Лега, Лёка, Лёша, Аля
Ольга - Ольгуня, Ольгуся, Ольгуха, Ольгуша, Оля, Олюля, Люля, Олюня, Олюся, Люся, Олюха, Олюша, Оляша, Оляня, Олёна, Лёна, Лёнля, Ляля
Онисим - Анисим, Анис,Анисимушка, Аниса, Сима, Оня
Орест - Ореста, Оря, Ора, Ростя
Павел - Павелка, Павлик, Павлуня, Павлуся, Павлуха, Павлуша, Павля, Павлюка, Павлюкаша, Паша, Пашуня, Пашута, Пашуха, Паня, Панюта, Панюха, Панюша, Паняша, Паля, Палюня
Пантелеимон - Пантелеймон,Пантелимон,Пантелеймонка, Пантя, Пантюха, Пантюша, Паня, Пана, Моня, Пантелейка, Пантелюха, Пантелюша
Пелагея - Палагея,Пелагейка, Пелага, Пелагуша, Поля, Полина, Полюся, Пуся, Полюха, Полюша, Палагейка, Палага, Паланя, Палаша
Пётр - Пётра, Петря, Петруня, Петруся, Петруха, Петруша, Петряй, Петрянка, Петряня, Петрята, Петряха, Петряша, Петя, Петёха, Петёша, Петюка, Петюня, Петюся, Петюха, Петюша, Петяй, Петяйка, Петяня, Петяха, Петяша
Платон - Платонка, Платоня, Платоха, Плата, Тоня, Тоха, Тоша
Полина - Полинка, Поля, Полюня, Полюся, Пуся, Полюха, Полюша, Поляха, Поляша, Пана, Пануля, Паша, Лина
Порфирий - Порфир,Перфил, Перфилий,Порфирьюшка, Порфирка, Порфиша, Фира, Перфиля, Перфиша
Прасковья - Парасковья,Парасковея, Прасковея,Прасковьюшка, Праскуня, Куня, Праскута, Прося, Проня, Параня, Паня, Панюша, Парася, Параха, Параша, Паша, Паня, Панюша, Пуня, Паруха, Паруша, Пора
Прокопий - Прокоп, Прокофий,Прокопьюшка, Прокопка, Прокоша, Прокша, Проня, Проша, Прокофа
Прохор - Прохорка, Проха, Проша, Проня, Проньша
Рада - Радка, Ада
Раиса - Раисья,Раиска, Рая, Раюся, Раюша, Раша, Иса
Рахиль - Рахилька, Раха, Раша, Рая, Хиля, Лиля, Иля
Регина - Регина, Рена, Рина, Гина
Рената - Ренатка, Рена, Ната
Римма - Риммушка, Риммура, Мура, Рима, Римуля, Рина
Ричард - Рич, Рик, Ричи, Рид
Роберт - Робертушка, Роба
Родион - Родионка, Родиоша, Родя, Родюша
Роза - Розка, Розуля, Заля
Роксана - Роксанка, Рона, Ксана, Сана, Саня
Роман - Романка, Ромаха, Ромаша, Романя, Рома, Ромася, Ромуля
Ростислав - Ростиславка, Ростя, Ростяна, Рося, Ротя, Слава, Славуня, Славуся
Рубен - Рубентьюшка, Рубеня, Беня
Руслан - Русланка, Руслаша, Русланчик, Руся, Лана
Руфина - Руфима,Руфинка, Руфа, Фина, Фима
Савва - Саввушка, Сава, Ава
Савелий - Савельюшка, Сава, Савёлка
Самсон - Самсонка, Соня
Самуил - Самойла,Самуилка, Самуня, Самуха, Саня, Самойлушка, Самоня, Самоха, Самоша
Сарра - Саррушка, Сара, Ара
Светлана - Светланка, Света, Светик, Светуля, Светуня, Светуха, Светуша, Вета, Лана
Святослав - Святославка, Свята, Света, Слава, Славик, Славуня, Славуся, Яся
Севастьян - Савастьян,Севастей,Севастьянка, Сева, Севчик, Севаша, Савостейка, Савося
Северьян - Савастьян,Северьянка, Северинка, Сева, Яна, Рина
Семён - Семенка, Сёма, Сеня, Сенюра, Сенечка, Сенюха, Сенюша, Сима, Симаня, Симоня, Оня
Серафим - Серафимка, Сима, Симуля, Симуня, Симура, Сюра, Симуха, Симуша, Сера, Фима, Има, Фимуля, Фина
Серафима - Серафимка, Сима, Симуля, Симуня, Симура, Сюра, Симуха, Симуша, Сера, Фима, Има, Фина
Сергей - Сергиян,Сергейка, Сернуля, Гуля, Сергуня, Сергуся, Сергуша, Серёжа, Серёга, Серж, Серёня
Сила - Силка, Силаша, Силаня
Сильвестр - Силивёрст, Сильвёрст,Сильвеструшка, Силя, Сива, Селя
Сильвия - Сильва,Сильва, Силя, Иля, Лия, Лика
Симона - Сима
Соломон - Соломонка, Солоня, Моня
Софья - Софьюшка, Софа, Соня, Сонюша
Спартак - Спартакушка, Спарташа, Пата, Патя
Спиридон - Свирид, Спиридоний,Спирид,Спиридонка, Спиридоша, Спиря, Свиридка, Свиря
Станислав - Станиславка, Станя, Стася, Слава, Славуня, Славуся, Стас, Стасик
Степан - Степанка, Степаня, Степаха, Степаша, Стёпа, Степуня, Степура, Степуха, Степуша, Стеша, Стеня, Стенюша
Сусанна - Сусанка, Санна, Сана, Суса, Аня
Таисия - Таиса, Таисья,Таися, Тася, Тасюта, Тая, Таюня, Таюта, Таюся, Таюха, Таюша, Туся, Ася, Таиска, Таисьюшка
Тамара - Тамарка, Тама, Тамуся, Тома, Томуля, Томуня, Томуся, Муся, Тата, Татуся, Туся, Мара
Тарас - Тараска, Ася
Татьяна - Татьянка, Таня, Танюха, Танюша, Танюра, Танюся, Танюта, Тата, Татуля, Татуня, Татуся, Туся, Таша
Тереза - Терезка, Теза, Теся, Реза
Терентий - Терентьюшка, Тереня, Терёня, Терёха, Терёша, Тёша, Теря, Терюша
Тимофей - Тимофейка, Тимоха, Тимоша, Тимоня, Тимося, Тимуня, Тюня, Тима, Тиманя, Тимаха, Тимаша, Тёма
Тимур - Тимурка, Тима, Мура
Тит - Титка, Титок
Тихон - Тихонка, Тихоня, Тиша, Тишечка
Трофим - Трофимка, Троха, Троша, Троня, Труня, Фима
Ульяна - Уля, Ульяха, Ульяша, Ляна, Яна, Юлианка, Юля, Лиана, Ана
Фаддей - Фадей,Фадейка, Фадя, Дея
Фаина - Фаинка, Фая, Фаюшка, Фаня, Фаля, Фася, Ина
Фёдор - Феодан,Фёдорка, Федя, Федюка, Федюля, Федюня, Дюня, Федюся, Дюся, Федюха, Федюша, Федяйка, Федяка, Федяня, Федяхя, Федяша
Федот - Федотий,Федотка, Федя, Дотя
Фёкла - Феклинья, Феклунья,Фёклушка, Феклуха, Феклуша
Феликс - Феля, Еля
Феодора - Федора, Дора,Федорка, Дора, Феня
Феодосий - Федос, Федосий, Федосей,Федося, Федя, Феся, Феша, Дося, Федосейка
Феодосия - Федосия, Федосья,Федосьюшка, Федося, Федя, Феня, Дося
Филипп - Филипий,Филипка, Филя, Филюха, Филюша, Липа
Флор - Фрол,Флёр,Флора, Лора, Фролка
Фома - Хома,Фомка, Фомушка
Харитон - Харитоний,Харитонка, Харитоня, Харитоша, Харитюня, Хоря
Христиан - Хрися, Христя, Аня
Христина - Христинья, Кристина,Кристинья,Христинка, Христя, Христюха, Христюша, Христюня, Христёна, Христоша, Хрися, Стина, Кристинка, Кристя, Крестя
Христофор - Христофорка, Христя, Христоня, Тоня, Христоша, Христя
Цецилия - Циля, Ция, Лия
Эвелина - Эвелинка, Элина, Эва, Эля, Веля, Лина
Эдита - Эда, Эдя, Дита
Эдвард - Эдуардик, Эдик, Эдя, Эдюня
Элеонора - Эля, Эла, Элюша, Леля, Лена, Леся, Лёля, Лёка, Лора, Нора
Элиза - Эля, Лиза
Эмма - Эмиля, Миля, Эма, Эля, Эмка, Эмуня
Эмиль - Эмилианка, Эмиля, Миля, Эма, Эля, Ляна
Эммануил - Эммануилка, Эма, Моня, Има, Ила
Эразм - Эрка, Эра
Эраст - Эра, Эрастка, Эрастушка, Эрик, Эрка
Юлиан - Ульян,Юля, Юлианка, Ляна, Уля, Ульяха, Ульяша
Юлия - Юля, Юла, Юлюся
Юрий - Юра, Юраня, Юрася, Юраха, Юраша, Юреня, Юрченя, Юка, Юша
Яков - Яковка, Якуня, Якуха, Якуша, Яша, Яшата, Яшуня, Яшута, Яшоня, Яня, Яся
Ян - Иоанн, Иван
Яна - Янка, Яника, Януша, Яня, Януся, Янина
Ярослав - Ярославка, Слава, Славуня, Славуся, Рося